y|b|b|y|b|b|y|b|b|y|
b|y|b|y|b|b|y|b|y|b|
b|b|y|y|y|y|y|y|b|b|
y|y|y|e|y|y|e|y|y|y|
b|b|y|y|e|e|y|y|b|b|
b|b|y|y|e|e|y|y|b|b|
y|y|y|e|y|y|e|y|y|y|
b|b|y|y|y|y|y|y|b|b|
b|y|b|y|b|b|y|b|y|b|
y|b|b|y|b|b|y|b|b|y|