b|b|b|b|r|r|b|b|b|b|
b|b|b|r|r|r|r|b|b|b|
b|b|r|r|r|r|r|r|b|b|
b|r|r|r|r|r|r|r|r|b|
r|p|p|p|p|p|p|p|p|r|
b|p|p|e|p|p|e|p|p|b|
b|p|p|p|t|t|p|p|p|b|
b|p|p|p|t|t|p|p|p|b|
b|p|p|p|t|t|p|p|p|b|
g|g|g|g|g|g|g|g|g|g|